111111111111111111111111111111
122222222222222222222222222221
122222222222222222222222222221
122222222222222222222222222221
1222222222222222222222222A2221
122222222222222222222222222221
122222222222222222222222222221
122222222222222222222222222221
122222222222222222222222222221
122222222222222222222222222221
122222222222222222222222222221
122222222222222222222222222221
122222222222222222222222222221
122222222222222222222222222221
122222222222222222222222222221
1222P2222222222222222222222221
122222222222222222222222222221
122222222222222222222222222221
122222222222222222222222222221
111111111111111111111111111111