111111111111111111111111111111
122222222222222222222222222221
122222222222222222222222222221
122222222222222222222222222221
122222222222222222222222222221
12222222222222P222222222222221
122222222222222222222222222221
122222222222222222222222222221
122222222222222222222222222221
122222222222222222222222222221
122222221111111111111222222221
122222222222221222222222222221
122222222222221222222222222221
122222222222221222222222222221
122222222222221222222222222221
122222222222221222222222222221
122222222222221222222222222221
12222B2222222222222222222B2221
122222222222222222222222222221
111111111111111111111111111111