111111111111111111111111111111
122222222222222222222222222221
12A222222222222222222222222A21
122212222222222222222222212221
122112222222222222222222211221
122222222222222222222222222221
122222222222222222222222222221
122222222222222222222222222221
122222222222222222222222222221
1222222222222222B2222222222221
122222222222222222222222222221
122222222222222222222222222221
122222222222222222222222222221
122222222222222222222222222221
122222222222222222222222222221
122222222222222222222222211221
122222222222222222222222212221
1222P2222222222222222222222A21
122222222222222222222222222221
111111111111111111111111111111