111111111111111111111111111111
122222222222222222222222222221
122222222222222222222222222221
122222222222222122222222222221
1222C2222222222122222222222221
122222222222222122222222222221
122222222222222122222222222221
122222222222222122222222222221
122222222222222222222222222221
122222222222222222222211111221
122222222222222222222222222221
122222222222222222222222222221
122222222222222222222222222221
122222222222222222222222222221
122222222222222222222222222221
1222P22222222222222222222C2221
122222222222222222222222222221
122222222222222222222222222221
122222222222222222222222222221
111111111111111111111111111111