111111111111111111111111111111
122222222222222222222222222221
122222222222222222222222222221
122E2222222222122222222222A221
122222222222221222222222222221
122222222111111111111222222221
122222222222222222222222222221
122222222222222222222222222221
122221222222222222222222122221
122221222222222222222222122221
12211122222222P222222222111221
122221222222222222222222122221
122221222222222222222222122221
122222222222222222222222222221
122222222111111111111222222221
122222222222221222222222222221
122A2222222222122222222222E221
122222222222222222222222222221
122222222222222222222222222221
111111111111111111111111111111