111111111111111111111111111111
122222222222222222222222222221
1222C2222222222222222222222221
12222222222222222222222222C221
122111111111111111111122222221
12A222222222222222222122222221
122222222222222222222122222221
122222222222222222222122222221
122211111112221222222122222221
12222222222222122E222222222221
1222A2222222221222222222222221
122222222222221222222222222221
122222222222221222222222222221
111111111222222222222222222221
122222222222222222222222222221
122222222222222222222122221111
122222222222222222222122222221
122B22222222222222222122222221
1222222222222222222221222222P1
111111111111111111111111111111