111111111111111111111111111111
122222222222222222222222222221
1222222222222222222222222A2221
122A22222222222222222222222221
122222222222222222222222222221
122222222111111111111222222221
122222222222122222222222222221
122222222222122222222222222221
122221222E22122222222222122221
122221222222122222222222122221
122221222222122F21222222122221
122221222222122221222222122221
122221222222122221222222122221
122222222222122221222222222221
122222222111111111111222222221
111222222222222222222222222221
122222222222222222222222222221
12221222222222222222222222C221
1P2212222222222222222222222221
111111111111111111111111111111